Dato,Region Nordjylland,Region Midtjylland,Region Syddanmark,Region Hovedstaden,Region Sj√¶lland,Hele landet
2020-03-16,0,2,0,4,4,10
2020-03-17,0,3,1,7,7,18
2020-03-18,1,4,2,10,7,24
2020-03-19,1,5,4,13,7,30
2020-03-20,2,5,5,16,9,37
2020-03-21,3,6,6,17,10,42
2020-03-22,4,5,6,22,9,46
2020-03-23,4,6,6,29,10,55
2020-03-24,7,12,7,33,10,69
2020-03-25,7,17,13,39,11,87
2020-03-26,8,17,14,42,13,94
2020-03-27,9,19,14,53,14,109
2020-03-28,10,21,18,58,14,121
